NO assets/north_wall.xpm
SO assets/south_wall.xpm
WE assets/west_wall.xpm
EA assets/east_wall.xpm

F 220,100,0
C 225,30,0

    1111111111111111111111111
    1000000000110000000000001
    1011000001110000000000001
    1001000000000000000000001
    1E00000000000000000000001
11111000000000000000000000001
10000000000000000000000000001
11111111111111111111111111111
