NO ./assets/wall_1.xpm
SO ./assets/wall_2.xpm
WE ./assets/wall_3.xpm
EA ./assets/wall_4.xpm
DO ./assets/door_redr.xpm

F 09,09,09
C 12,12,35

111111111111111111111111111111111111
100000000000000000111111111111111111
101010101010101010111111111111111111
101010101010101010111111111111111111
101010101010101010111111111111111111
101010101010101010111111111111111111
101010101010101010111111111111111111
101010101010101010111111111111111111
101010101010101010111111111111111111
101010101010101010111111111111111111
101010101010101010111111111111111111
101010101010101010111111111111111111
101010101010101010111111111111111111
101010101010101010111111111111111111
101010101010101010111111111111111111
101010101010101010111111111111111111
101010101010101010111111111111111111
101010101010101010111111111111111111
101010101010101010111111111111111111
101010101010101010111111111111111111
101010101010101010111111111111111111
101010101010101010111111111111111111
101010101010101010111111111111111111
101010101010101010111111111111111111
101010101010101010111111111111111111
101010101010101010111111111111111111
101010101010101010111111111111111111
101010101010101010111111111111111111
101010101010101010111111111111111111
101010101010101010111111111111111111
101010101010101010111111111111111111
101010101010101010111111111111111111
101010101010101010111111111111111111
101010101010101010111111111111111111
101010101010101010111111111111111111
101010101010101010111111111111111111
101010101010101010111111111111111111
101010101010101010111111111111111111
101010101010101010111111111111111111
101010101010101010111111111111111111
101010101010101010111111111111111111
101010101010101010111111111111111111
101010101010101010111111111111111111
101010101010101010111111111111111111
101010101010101010111111111111111111
101010101010101010111111111111111111
101010101010101010111111111111111111
101010101010101010111111111111111111
101010101010101010111111111111111111
101010101010101010111111111111111111
101010101010101010111111111111111111
101010101010101010111111111111111111
101010101010101010111111111111111111
101010101010101010111111111111111111
101010101010101010111111111111111111
101010101010101010111111111111111111
101010101010101010111111111111111111
101010101010101010111111111111111111
101010101010101010111111111111111111
101010101010101010111111111111111111
101010101010101010111111111111111111
101010101010101010111111111111111111
101010101010101010111111111111111111
101010101010101010111111111111111111
1010101010101010101111111111111111111
101010101010101010D001000001000001001
1010101010101010101001001001001001001
1010101010101010101000001001001000001
1010101010101010101001001000001001001
1010101010101010101000000000000000001
1010101010101010101000011111111000001
1010101010101010101111000000000001111111111111111111111
101010101010101010100000010101000000D00011111E0000000011
101010101010101010101111111111111111111011111100000000011
1010101010101010101011111011111111111110111111100000000011
10000000000000000010111100011111111111101111111100000000011
10000000000000000010111000001111111111101111111110000000001
10000000000000000010110000000111111111101111111100000000011
1000000000000000001010000100001111111110111111100000000011
100000000000000000100000111000011111111011111110000000001
100000000000000000D0000111110000D00000000000D000000000111
10000000000000000010000011100001111111111111111111111111
1000000000000000001D1000010000111
100000000000000000101100000001111
100000000000000000101110000011111
100000000000000000101111000111111
101010101010101010101111101111111
101010101010101010101111111111111
1010101010101010101D11111111111111111111111
1010101010101010101000110000100000000000001
1010101010101010101000110000000000111101001
1010101010101010101000110000000000110001001111111111
1010101010101010101000000000000000000001000000000001
1010101010101010101111111111111111111111111111111101
101010101010101010D000000000000000000000000000000001
1010101010101010101000000000000000000000000001000001
1010101010101010101000000000000000000000000000000001
1010101010101010101000000000000000000000001000000001
1010101010101010101000000000000000000000000000000001
1010101010101010101000000000000000000001000000000001
1010101010101010101000000000000000000000000000000001
1010101010101010101000000000000000001000000000000001
1010101010101010101000000000000000000000000000000001
1010101010101010101000000000000001000000000000000001
1010101010101010101000000000000000000000000000000001
1010101010101010101000000000001000000000000000000001
1010101010101010101000000000000000000000000000000001
1010101010101010101000000000100000000000000000000001
1010101010101010101000000000000000000000000000000001
1010101010101010101000000010000000000000000000000001
1010101010101010101000000000000000000000000000000001
1010101010101010101000001000000000000000000000000001
10101010101010101010000000000000000000000000000000011111
101010101010101010100010000000000000000000000000000D0001
10101010101010101010000000001111000000000000000000011101
101010101010101010111111111111111D1111111111111111111101
10101010101010101011111111111111101111111111111111111101
10101010101010101011000000000000000000000000000111111101
10101010101010101011100000000000000000000000001111111101111
10101010101010101011110000000000000000000000011111111100011
10101010101010101011111000000000000000000000111111111111011
10101010101010101011111100000000000000000001111111111111011
1010101010101010101111111D111111111111111D11111111111111011
10101010101010101011111110111111111111111011111111111110011
10101010101010101011111110111111111111111011111111111110111
10101010101010101011111110111111111111111011111111111110111
10101010101010101011111110111111111111111011111111111110111
10101010101010101011111110111111111111111011111111111110001
10101010101010101011111110111111111111111011111111111111101
10101010101010101011111110111111111111111011111111111111101
101010101010101010D0000000111111111111111000000000000000001
10101010101010101011111111111111111111111111111111111111111
1010101010101010101111111111111111111111111111111111
1010101010101010101111111111111111111111111111111111
1010101010101010101111111111111111111111111111111111
1010101010101010101111111111111111111111111111111111
1010101010101010101111111111111111111111111111111111
1010101010101010101111111111111111111111111111111111
1010101010101010101111111111111111111111111111111111
1010101010101010101111111111111111111111111111111111
1010101010101010101111111111111111111111111111111111
1010101010101010101111111111111111111111111111111111
1010101010101010101111111111111111111111111111111111
1010101010101010101111111111111111111111111111111111
1010101010101010101111111111111111111111111111111111
1010101010101010101111111111111111111111111111111111
1010101010101010101111111111111111111111111111111111
1010101010101010101111111111111111111111111111111111
1010101010101010101111111111111111111111111111111111
1010101010101010101111111111111111111111111111111111
1010101010101010101111111111111111111111111111111111
1010101010101010101111111111111111111111111111111111
1010101010101010101111111111111111111111111111111111
1010101010101010101111111111111111111111111111111111
1010101010101010101111111111111111111111111111111111
1010101010101010101111111111111111111111111111111111
1010101010101010101111111111111111111111111111111111
1010101010101010101111111111111111111111111111111111
1010101010101010101111111111111111111111111111111111
1010101010101010101111111111111111111111111111111111
1010101010101010101111111111111111111111111111111111
1010101010101010101111111111111111111111111111111111
1010101010101010101111111111111111111111111111111111
1010101010101010101111111111111111111111111111111111
1000000000000000001111111111111111111111111111111111
1111111111111111111111111111111111111111111111111111