NO ./assets/north_wall.xpm
WE ./assets/west_wall.xpm
EA ./assets/east_wall.xpm
SO ./assets/south_wall.xpm
DO ./assets/door.xpm


C 135,206,0
F 128,18,128


1111 111111111111111111
1000100000000000000011 
11111100000000E1111111
10000000000000000000001
1110000000D00000000001    
1111111111111111111111

