NO ./assets/north_wall.xpm
WE ./assets/west_wall.xpm
EA ./assets/east_wall.xpm
SO ./assets/south_wall.xpm
DO ./assets/door.xpm



C 135,206,0
F 128,128,128

11111111111111111111111111111111111111111111111111111111111111111111111111111111111   
100000000000000000000000000000000000000000000000000000000000E0000000000000000000001
 11111111D11111111111111111111111D1111111111D11111111111111111111111D111111111111111
        1011                    101        1011                    1011
        1011                    101        1011                    1011
        101111111111111111111111101111111111011111111111111111111111011
        10D00000000000000000000000000000000000000000000000000000000D011
        101111111111111111111111101111111111011111111111111111111111011
        1011                    101        1011                    1011
111111111D11111111111111111111111D1111111111D11111111111111111111111D111111111111111111111111111
110000000000000000000000000000000000000000000000000000000000000000000000000000000000000000000111
1000000000000000000000011000000000000000000000100000000000000000000001100000000000000000000001111
1000000000010000000000100000000000010000000000000000000001000000000001100000000001000000000001111111
1000000000000000000000000000000000000000000000100000000000000000000001100000000000000000000001111111111
111111111111111111111111111111111111111111111111111111111111111111111111111111111111111111111111111111 111111111

